SO textures/eagle.xpm
NO textures/side_2.xpm

C 0,60,150
F 150,150,150

WE textures/wall_2.xpm
EA textures/wall.xpm

11111111111111111111111111111111111111111111111111111111111111111111111111111111111111111111111111
10000000000000000000000000000000000000000000000000000000000000000000000000000000000000000000000001
10000000000000000000000000000000000000000000000000000000000000000000000000000000000000000000000001
10000001001001000000000000000000000000000000000000000000000000000000000000000000000000000000000001
10000000000000000000000000000000000000000000000000000000000000000000000000000000000000000000000001
10000001001001000000000000000000000000W00000000000000000000000000000000000000000000000000000000001
10000000000000000000000000000000000000000000000000000000000000000000000000000000000000000000000001
10000001001001000000000100000000000000000000000000000000000000000000000000000000000000000000000001
10000000000000000000000100000000000000000000000000000000000000000000000000000000000000000000000001
10000000000000000000000100000000000000000000000000000000000000000000000000000000000000000000000001
10000000000000000001111111110000000000000000000000000000000000000000000000000000000000000000000001
10000000000000000000000100000000000000000000000000000000000000000000000000000000000000000000000001
10000000000000000000000100000000000000000000000010000000000000000000000000000000000000000000000001
10000000000000000000000100000000000000000000000011111111111111111111111111111111111111111111111111
1000000000000000000000000000000000000000000000001
1000000101000000000000000000000000000000000000001
1000000101000000000000000000000000000000000000001
1000000101000000000000000000000000000000000000001
1000000101111110000000000000000000000000000000001
1000000100000000000000000000000000000000000000001
1000000111111110000000000000000000000000000000001
1000000000000000000000000000000000000000000000001
1111111111111111111111111111111111111111111111111