SO textures/eagle.xpm
NO textures/side_2.xpm

C 50,50,50
F 0,180,255

WE textures/wall_2.xpm
EA textures/wall.xpm

11111111111111111111111111
10000000000000000000000001
10000000000010000000000001
11111100000000000001111111
     1000000N0000001
     100000000000001
111111000000000000011111111
100000001111111100000000001
100000001      100000000001
111111111      111111111111
